公司	地址
江小鱼
由	谁	选出
巴纳德星	表面温度
属于	什么	族                            族	：	春	黄菊	族
金像奖	主持人	是谁	
第1条	是什么
分子式	是什么
本意	是什么
应用商店	里	有	多少个	应用
名字	是什么
三字	代码	是什么
以前	是哪个	俱乐部
纬度	是什么
有限公司	在哪	上市	
外来人口	有多少
是	哪个	朝代	的
还	叫	什么	车
最后	和	谁	结婚	了
由	多	宽
包括	几个	部分
作者	是	谁
由	哪些	平台
存在于	哪里	
相对	密度	多少
淡水湖	是	什么	湖
理子	几	岁	打球
创建	时间
氏族谱	说	了	什么
哪年	开始	正式
	获得	什么	奖项
动漫	是	什么	的	缩写
工作	有	多少人
杨过	属	什么	的
年	降雨量	多少	
指	什么	季节
梅西	多	大
篮球	起源于	哪国	
充值卡	有	几种	面额	
年	获	什么	称号
偏旁	是	什么
多少	代	君王
少于	多少	毫升	称为	月经量	少
选择	什么样	的	树种
工作温度	是多少
刻有	多少	个	字
是谁	演唱	的
董事长	是谁	
国家	几	级	口岸
官方	语音	是	什么	
专业	代码	多少	
格式	是什么
专辑	卖	了	多少	张
英文	怎么	翻译
有多少	耕地
体验	馆	在哪	
安徽	卫视	什么	奖
定价	多少	钱
属于	哪个	镇
区鸟	是什么
多少	个	站台
有	什么	能力
核电荷	数	是多少
个	学院	
出生地	是哪	
纹枯病	多少	度